WE ./stone3.xpm
NO ./stone12.xpm
SO ./stone2.xpm
EA ./stone4.xpm

F 240,211,117
C 84,171,179

1111
1N01
1111